%%%%%%%%%%%%%%%%%%%%%%%%%%%%%%%%%%%%%
%                                  P%
%            %                      %
%            %                      %
%            %                      %
%            %                      %
%            %                      %
%            %      %               %
%            %      %               %
%            %      %               %
%            %      %               %
%            %      %               %
%            %      %               %
%            %      %               %
%%%%%%%%%%%%%%      %%%%%%%%%%%%%%%%%
%            %                      %
%            %                      %
%            %                      %
%     .                             %
%                                   %
%                                   %
%                                   %
%%%%%%%%%%%%%%%%%%%%%%%%%%%%%%%%%%%%%
