%%%%%%%%%%%%%%%%%%%%%%%%%%%%%%%%%%%%%
%                                  P%
%                                   %
%            %     .                %
%            %                      %
%%%%%%%%%%%%%%%%%%%%%%%%%%%%%%%%%%%%%
